################################
##.........###.....##.......####
##*...###.*....###....####..####
###..######.....#########.....X#
###.....#####..########...######
###....*#####..#######..########
#....#####.....###.##...##...#.#
#*..####....##...#####..##.#..##
##....#######..###.##.....##.###
####.....*#.....###....##.##...#
#@.....####...#######..####....#
#####........#####.....*..###..#
################################