☐☐☐☐☐☐☐☐☐☐☐☐☐☐☐☐☐☐☐☐☐☐☐☐☐☐☐☐☐☐☐☐
☐☐.........☐☐☐.....☐☐.......☐☐☐☐
☐☐*...☐☐☐.*....☐☐☐....☐☐☐☐..☐☐☐☐
☐☐☐..☐☐☐☐☐☐.....☐☐☐☐☐☐☐☐☐.....✖☐
☐☐☐.....☐☐☐☐☐..☐☐☐☐☐☐☐☐...☐☐☐☐☐☐
☐☐☐....*☐☐☐☐☐..☐☐☐☐☐☐☐..☐☐☐☐☐☐☐☐
☐....☐☐☐☐☐.....☐☐☐.☐☐...☐☐...☐.☐
☐*..☐☐☐☐....☐☐...☐☐☐☐☐..☐☐.☐..☐☐
☐☐....☐☐☐☐☐☐☐..☐☐☐.☐☐.....☐☐.☐☐☐
☐☐☐☐.....*☐.....☐☐☐....☐☐.☐☐...☐
☐@.....☐☐☐☐...☐☐☐☐☐☐☐..☐☐☐☐....☐
☐☐☐☐☐........☐☐☐☐☐.....*..☐☐☐..☐
☐☐☐☐☐☐☐☐☐☐☐☐☐☐☐☐☐☐☐☐☐☐☐☐☐☐☐☐☐☐☐☐