################################################################
#.......####*................########........###....#####..X####
#...##..*#####..##.#########...###.....#####...##....####...####
##*##...######*..#.####....###....##...#####......##.........*.#
#######..@.......######....######....*.#...#####################
################################################################