☐☐☐☐☐☐☐☐☐☐☐☐☐☐☐☐
☐✖.....☐☐☐☐..*.☐
☐☐☐☐☐☐.☐☐...☐☐☐☐
☐☐☐☐...☐☐☐☐.☐☐.☐
☐☐*...☐☐☐☐..☐.*☐
☐☐☐☐☐..☐....☐..☐
☐☐...@.........☐
☐☐☐☐☐☐☐☐☐☐☐☐☐☐☐☐