################
#X.....####..*.#
######.##...####
####...####.##.#
##*...####..#.*#
#####..#....#..#
##...@.........#
################