☐☐☐☐☐☐☐☐☐☐☐☐☐☐☐☐☐☐☐☐☐☐☐☐☐☐☐☐☐☐☐☐☐☐☐☐☐☐☐☐☐☐☐☐☐☐☐☐☐☐☐☐☐☐☐☐☐☐☐☐☐☐☐☐
☐.......☐☐☐☐*................☐☐☐☐☐☐☐☐........☐☐☐....☐☐☐☐☐..✖☐☐☐☐
☐...☐☐..*☐☐☐☐☐..☐☐.☐☐☐☐☐☐☐☐☐...☐☐☐.....☐☐☐☐☐...☐☐....☐☐☐☐...☐☐☐☐
☐☐*☐☐...☐☐☐☐☐☐*..☐.☐☐☐☐....☐☐☐....☐☐...☐☐☐☐☐......☐☐.........*.☐
☐☐☐☐☐☐☐..@.......☐☐☐☐☐☐....☐☐☐☐☐☐....*.☐...☐☐☐☐☐☐☐☐☐☐☐☐☐☐☐☐☐☐☐☐☐
☐☐☐☐☐☐☐☐☐☐☐☐☐☐☐☐☐☐☐☐☐☐☐☐☐☐☐☐☐☐☐☐☐☐☐☐☐☐☐☐☐☐☐☐☐☐☐☐☐☐☐☐☐☐☐☐☐☐☐☐☐☐☐☐