--------
-......-
------.-
----...-
--....--
-----..-
--@...--
--------